aan: sfd lgg klx
abt: vcs yvg nnb
afk: yrh wwz
agc: oek eds
agr: pcz omw
ahr: rnw
ahy: lfd ive
akc: gqr rrs qoi
alh: ooa cub
apc: cae qqp
aqd: uft
arm: ddi wjp
asj: yhv oyz
aso: gij wgo
asv: kbp siz mkn
atk: oxb lzk
auh: cub ooa
avw: xyw
awz: gkh
axd: esg vub wrs cnr
axv: xyw bjj
ayf: foi lap hdp fes
bbf: mfc
bbu: yza lbs wnt
bcp: yhv uyb oyz
bds: bvm nfm kts
beg: out
bey: ovo rnw rmn awz kmv
bgp: cjp
bhs: out
bid: xyo kor ywb rtk ozq jjn
bie: xis trn
bjj: kgx cii mbv uzf hpv rok aso rpf eai qlq srd htg vpq cnn mvv rxt icw dfv pav yjs svm axd lqs
bjr: gwt qrb
blh: bie gwt qrb
bli: qix ixj
blv: zpb tqj
blx: vnv plt uqv
bna: wxi tya fwq
bpb: uwx
bqf: qbg yrh
btt: qix eor vbw
btu: foi
btx: bjj cin
bvm: zhm whc agr
bvz: isk
bwj: nni
cae: tlf jds qki mrg
cbn: cvv klx
cgd: pcd rea qkg
cge: qjf pfe
cgq: hyr tun fei
chy: nyd vzu cmz
cii: ojz urx
cin: yjs rxt srd dfv aso eai axd
cjp: ovj ctp zgm jbh gym gra ikl zob gju oqw agc dga ljf vwx bds lrv teg ndz bwj
cmc: ooa jcy cub
cmv: xnv yct
cmz: bjj mfc xyw
cnn: urx ojz jtq
cnr: vse may tqj zpb
cot: zrr sdm
cpl: wii
cqj: uyb oyz
crj: pgb rye alh
crv: sdm rwt
ctf: ufu iep
ctp: ktj tft
cub: rtk tga dtw jjn knm poh qqq dki iej
cvv: bcp mtf jdq asj
czy: wlu
dac: sxv emj
dct: mfc bjj xyw cin
ddi: jtk
dfi: xcr
dfv: ojz
dga: kts nfm bvm
dki: hzv nwl sei nsg peg
dlw: bie qrb
dly: jcy cub
dni: cin xyw mfc
dob: iep auh
dof: nwa jed tif
dpn: pcd rea
drh: nog wia qww
dsv: jed txn tif
dtw: hzv nwl peg
dwz: pcy
dxf: kxy nju
dyd: qeh chy
eai: ren
ebu: gyo qqp
ecy: cub bid
eds: lgb ony
eeo: lzk lkk
efw: wia qww tln lkc
egc: ysw xrt
ehu: meq nwe qqg igv
ehw: dob ctf
ekb: dly qmy hwv
emj: you
eoa: nfw
eom: gyo
eor: ooa
eqo: xyw cin bjj mfc
esg: zpb tqj vse
ewa: qww tln
ewr: zrr izy
fau: fmk rpb srh
fbb: qlj uyb
fco: tun fei uzy
fct: cjp tgk
fdm: bid
fei: cjp you ykg
fes: rlt ldh
ffa: cgq oli fco yga saj
fft: yzt blx jpn xrt ysw
fgg: hzg ddi qae skk
fgo: out
fje: mfc bjj cin
fjv: nxt oae
fmk: ivr oyg fno ipz
fno: gkl fjv jcm
foi: rlt otu
fql: fes hdp lap
fsk: ffa hbl tan
fuj: gci dly
fuo: vxm
fvw: wei
fwq: zno dxf
fwv: xmv vja ntl
gaq: inl pmh bey ofx pof asv ohv nkx kao mpg
gaz: axv ziq rcz
gbg: msf svn bgp
gci: ooa jcy
gcs: tgk ykg
ggb: xed
gho: svn msf bgp
gij: yow
gjk: pcy
gjs: ysw xrt jpn blx yzt
gju: kts nfm
gkh: wxi oim fwq
gki: mjz pss
gkl: oae
gkm: gni grr
gms: lqa siz kbp
gni: qzv efw
gor: jdr nim xcr
gpn: jcy
gpr: bid jcy cub
gqr: fft gjs ymt
gra: kts
grr: moo qzv efw ewa drh
gwt: bbu
gwu: rcz
gxr: skk
gym: vja
gyo: tlf mjr qki mrg
haj: klx cvv sfd
hbl: cgq oli yga saj
hcc: qlj uyb oyz
hdp: ldh otu
hhl: xyw
hjd: out
hmc: cin mfc
hmf: jcy
hmx: fmk
hni: gor zsd
hpv: rfb
hsx: out
htg: izo sho btt bli
htl: axv rcz qop
huf: nps
huw: dof
hvz: pgb mbm rye
hwv: cub jcy ooa
hwx: kpe mga
hyr: you
hzg: bhs yck
hzv: nhd
iag: xnv vke
icw: urx
iej: nfw xcf
iep: bid jcy cub
igf: fgg mhd arm
igv: xed
ikl: nfm bvm
ils: oqh
inl: wst ehu qqa
ipz: upm gkl fjv
irf: hdp fes
irn: dct qug pgs
isk: xlx vzx
ive: xed nju kxy
ivr: upm jcm gkl fjv
iwy: vke rhq
ixj: cub jcy
ixr: rpb
iyx: ahy wlw
izo: vbw eor gpr ixj
izy: out
jbh: wuo
jbx: upm jcm gkl
jcm: oae nxt
jcy: qqq xzi wqn tga eoa dki jjn xyo ywb kor ous mni gkm
jdq: yhv uyb
jdr: ewr cot jlm crv
jds: cmv
jed: mfc xyw cin
jjk: lgg cvv sfd
jjn: sei nsg peg
jkd: nsb ymd huw
jlm: zrr rwt sdm izy
jpn: vnv
jtb: gcs uwx xvw
jtk: out
jtq: ybb
jzd: oqh mxu
kao: vts plr bqf
kbp: ydb xob ggb unc
kgx: ekb viq
kjo: hbl
klx: asj fbb bcp jdq
kmv: bna gkh
knm: bpb vyn
kor: nfw zpz
kpa: iep hmf ufu cmc
kpe: uft qcx htl gwu gaz
ksc: qbg
ksw: xvw gcs
ktj: fql irf btu
ktn: blx jpn xrt
kts: agr zhm zae
kxy: ebu jjk haj eom fau ixr tlo ttm apc qda blh
kyg: egc gjs ymt
lap: ldh otu
lbs: uyb oyz
ldh: rnx zzx tpx
ldu: cub
led: qzv drh
lfd: kxy
lgb: gxr mhd arm zee fgg
lgg: jdq fbb asj
lin: fgo
lix: wii
ljf: nni oek
lkc: tgk ykg you cjp
lkk: kpe
llf: bvz
lll: bey pmh inl gms mpg nkx ohv ofx fuo sha ahr nee xpe asv mcv
lmv: pcy ztn
lnv: rtf bvz zpi
lqa: ggb xob
lqs: fuj
lrv: ved lto hni
ltc: wul rhq vke
lto: way pgj dfi gor
lzk: nkd
mau: bjj cin
may: gpn fdm nlq szf
mbm: ooa cub
mbv: fuj ekb viq
mcv: mkn siz lqa
meq: nju xed
mfc: icw qlq eai vpq htg pav cnn mbv svm yjs
mga: htl uft qcx gaz
mhd: hzg ddi wjp skk
mjr: iwy ltc
mjz: tif hmc txn nwa jed
mkn: unc
mni: peg sei nwl hzv
moo: qww tln nog
mpg: kmv awz ovo rmn
mqm: uso
mrg: yvj ltc iag cmv
msf: you ykg tgk cjp
mtf: oyz yhv
mtp: oqh rfk
mvv: urx
mxu: fje btx hhl wal
myt: foi lap hdp
nar: mfc bjj cin xyw
ndz: eds oek nni
nee: afk vts ksc bqf
nfm: whc
nfw: raa dac lix cpl
nhd: sds gho
nim: ewr jlm crv rej
nju: qnr poc cbn akc hmx haj ebu yez ixr bjr vaz tlo eom fau
nkd: gaz qcx uft
nkg: gcs
nkx: iyx
nlq: ooa jcy cub
nnb: mau bbf avw eqo nar
nni: npo
nog: cjp ykg you tgk
npo: mhd arm fgg gxr
nps: xed
nsb: pss mjz dof
nsg: psk tnb nhd
ntk: cnr wrs
ntl: ztd
ntx: ytw
nvs: ztn abt
nwa: bjj
nwb: jcy cub
nwe: xed
nwl: psk tnb
nxt: uyb qlj oyz
nyd: cin
oae: uyb yhv
ocg: qcx uft htl gwu gaz
oek: igf
ofg: saj oli
ofx: wst ybq qqa ehu
ohv: vts ksc bqf
oim: weh dxf zno ytw opp
ojz: seb pao ybb
oli: tun
omj: oxb lzk hwx
omw: ufi
ony: mhd
ooa: jjn xzi eoa ozq dki kor tga rtk ous mni
opp: xed
oqh: btx fje wal
oqw: lto
ose: wlw ahy
otu: zzx rnx
otz: uso chy
ous: sei nsg peg
ovj: vja xmv
ovo: ukm
ovp: aqd nkd ocg
oxb: mga aqd kpe ocg
oyg: fjv jcm upm
oyz: rqd dwz tes tdq eeo mqm jzd sti wdx vak ruj omj gjk atk lmv jkd otz pdl rnk nvs dpn xva ils cgd mtp dyd
ozq: led gni
pao: nwb ues yon
pav: izo bli sho
pcd: pub
pcy: vcs nnb
pcz: qic zyz ufi
pdl: ovp hwx lzk oxb
pdq: ayf fql myt irf btu
peg: psk tnb nhd
pfe: nju xed
pgb: jcy bid
pgj: nim
pgs: mfc bjj xyw
pii: mxu zfo
plr: yrh
plt: oyz yhv
pmh: wst ehu ybq
poc: cvv sfd
pof: uob fvw iyx
poh: nfw zpz xcf
ppo: kpa
psk: gbg vvk
pss: hmc tif nwa
pub: dct pgs qxa
pxj: dfi pgj way
pye: ved
qae: yck bhs qtl
qbg: cge huf sfu
qcx: rcz qop axv
qda: gqr kyg qoi
qeh: cmz nyd
qic: hsx
qix: bid
qjf: nju
qkg: tku irn
qki: iag iwy yvj
qlj: xva nvs dpn dyd mtp cgd pdl rnk gjk otz jkd lmv atk pii ruj wdx vak sti eeo mqm jzd dwz tes tdq
qlq: crj
qmy: bid cub jcy
qnr: fmk rpb
qoi: ktn fft
qop: mfc
qqa: igv vkm qqg
qqg: kxy xed
qqp: tlf mjr jds mrg
qqq: zpz
qrb: trn bbu skd
qtl: out
qug: bjj
qvw: ehw ppo yow
qww: cjp tgk you
qxa: cin mfc
qzv: wia nog tln lkc
raa: sxv emj
rcz: bjj mfc cin
rea: pub tku irn
rej: zrr rwt sdm
ren: rye pgb mbm ecy
rfb: rsk
rfk: fje
rhq: uyb
rit: ofg ffa taw
rlt: tpx zzx rnx
rmn: gkh ukm bna
rnk: oqh
rnw: ukm
rnx: out
rok: rfb gij
rpb: oyg jbx ivr ipz
rpf: qvw wgo gij
rqd: ymd nsb gki
rrs: ymt egc fft gjs
rsk: kpa dob ctf
rtf: swo
rtk: rit upc fsk kjo uht
ruj: pcd qkg
rwt: out
rxt: btt
rye: jcy bid
saj: uzy fct
sdm: out
sds: vae bgp
seb: yon
sei: nhd
sfd: jdq bcp asj
sfu: zmb qjf
sha: kmv rmn ovo rnw
sho: gpr ixj qix vbw eor
siz: xob ggb
skd: yza cqj wnt vmk
skk: qtl yck jtk
srd: viq
srh: jbx ipz
sti: gki huw nsb
svm: crj wlu ren hvz
svn: cjp ykg you tgk
svr: lll vny xvx gaq
swo: yxl xlx
sxv: tgk ykg cjp
szf: ooa
tan: oli yga cgq
taw: saj oli yga fco
tdq: chy
teg: eds
tes: abt ztn pcy
tft: btu irf myt fql
tga: jtb bpb
tgk: bwj ndz fwv teg bds lrv vwx ljf oqw gju ikl gra dga agc ovj gym jbh pye zgm
tif: xyw bjj mfc
tku: qxa dct qug
tlf: iag iwy ltc
tln: tgk you ykg
tlo: fmk
tnb: gbg vvk
tpx: out
tqj: zne fdm szf
trn: cqj
ttm: gqr rrs kyg qoi
tun: ykg tgk cjp
txn: cin mfc bjj
tya: opp
tzi: qjf
ues: ooa jcy cub
ufi: fgo hsx beg
uft: rcz ziq
ufu: cub
uht: taw ffa tan ofg
ukm: oim fwq ntx
unc: kxy xed
uob: ahy wei
upc: hbl taw ffa tan ofg
upm: hcc
uqv: oyz uyb qlj
urx: seb
uso: vzu
uwx: cjp
uyb: mqm pii eeo nvs rnk gjk tes dwz wdx tdq lmv
uzf: wrs blv cnr
uzy: tgk cjp
vae: you ykg tgk
vak: huw gki nsb ymd
vaz: gyo cae qqp
vbw: ooa jcy cub
vca: bvz zpi
vcs: eqo mau nar
ved: dfi gor zsd
viq: qmy
vja: ztd vca lnv
vke: yhv uyb
vkm: kxy nju
vmk: qlj yhv uyb oyz
vnv: uyb qlj
vny: bey inl gms mpg nkx ohv ofx fuo wzh ahr nee kao xpe asv mcv pof
vpq: wgo
vse: szf nlq fdm zne
vts: yrh
vub: may
vvk: msf svn
vwx: tft ktj pdq
vxm: nwe
vyn: uwx
vzu: bjj mfc
vzx: out
wal: cin xyw mfc
way: jdr
wdx: uso chy
weh: kxy nju xed
wei: lfd wvv
wgo: ehw
whc: omw xry pcz
wia: cjp
wii: tgk you cjp
wjp: bhs yck
wlu: ecy pgb rye
wlw: ive wvv
wns: lin
wnt: yhv uyb
wqn: uht kjo fsk upc rit
wrs: may vse
wst: igv qqg meq nwe
wul: qlj yhv
wuo: llf
wvv: xed kxy
wwz: sfu
wxi: weh dxf
wzh: wst ybq ehu
xcf: raa dac cpl
xcr: jlm rej crv ewr
xed: eom fau blh dlw bjr apc vaz akc hmx jjk aan ebu haj yez ixr qnr poc qda
xis: cqj yza lbs vmk wnt
xlx: out
xmv: ztd llf lnv
xnv: oyz yhv uyb
xob: xed nju
xpe: ose iyx fvw uob
xrt: plt
xry: zyz qic
xva: hwx ovp lkk
xvw: cjp tgk you ykg
xvx: inl gms bey pmh ofx mpg sha wzh fuo pof mcv xpe kao ahr
xyo: nkg ksw jtb vyn
xyw: htg srd vpq cnn icw dfv pav yjs svm axd lqs ntk kgx mbv uzf czy hpv ysj rok aso rpf qlq eai
xzi: uht kjo fsk
ybb: yon ldu nwb
ybq: vkm
yck: out
yct: oyz qlj
ydb: nju kxy xed
yez: qrb gwt
yga: uzy
yhv: xva nvs dpn dyd mtp cgd ils pdl rnk gjk omj otz jkd atk lmv pii ruj vak sti eeo mqm jzd dwz rqd tdq
yjs: esg
ykg: ctp ovj gym ikl gju gra fwv lrv bds vwx ljf bwj
ymd: mjz dsv pss
ymg: xlx
ymt: blx ysw
yon: bid jcy cub
you: teg ndz ljf dga agc ikl zob oqw gra jbh gym zgm pye ctp ovj
yow: kpa dob
yrh: tzi
ysj: hvz wlu crj
ysw: vnv
ytw: kxy
yvg: bbf eqo
yvj: yct wul rhq vke
ywb: grr gni led
yxl: out
yza: uyb qlj oyz
yzt: plt uqv vnv
zae: wns omw pcz
zee: wjp qae ddi
zfo: dni
zgm: pxj
zhm: pcz xry
ziq: mfc bjj xyw cin
zmb: kxy nju
zne: cub bid
zno: nju kxy
zob: pdq
zpb: zne fdm
zpi: swo ymg isk
zpz: cpl raa
zrr: out
zsd: jdr xcr
ztd: zpi
ztn: yvg nnb
zyz: beg hsx hjd
zzx: out
